2222222222222222
2222222222222222
2222222222222222
2222222222222222
2222222222222222
2222222222222222
2200222222222022
2220222222222022
0000022222220000
0000220020022200
0000000020000000
0000000000000000
0000000000000000
0000000000000000
0000000000000000
0000000000000000