0000000000000000
0000000111100000
0000000111100000
0000000111111100
0001110010000000
0000010010000000
0000111110000000
0000100000000000
0011111100000000
0010100000000000
0000111111010000
0000000001010000
0000000001110000
0000000000010000
0000000000000000
0000000000000000